R 800 800
NO ./textures/bookshelf.xpm
SO ./textures/cracked_stone_bricks.xpm
EA ./textures/purplestone.xpm
WE ./textures/piston_top.xpm
S ./textures/barrel.xpm
F 255,0,255
C 51,26,255

1111111111111111111111111111111111
10000W0020010000000100000111110111
1000000000010000000100000000000001
1000121100010000000011111110000001
1000101000010000000100000000000001
1000101000011100111111111110111111
10000200000000000001      101
10000000000000000001111111101
10000200000000000000000000001
10000000000000000001111111111
11111111111111111111
