R 1280 720
NO ./textures/bookshelf.xpm
SO ./textures/cracked_stone_bricks.xpm
WE ./textures/piston_top.xpm
EA ./textures/purplestone.xpm
S ./textures/barrel.xpm
F 255,0,255
C 51,26,255

1111111111111111111111111111111111
1000000000010202020100000111110111
1000000000010000000100000000000001
1000101000010202020111111100000001
1000101000N100000001000000000000001
1000101000011100111111111110111111
12000000002000000001      101
10002000000000000021111111101
100000000000000020000000000001
100000200000000000211111111111
11111111111111111111