R 3200 1755
NO ./textures/bookshelf.xpm
SO ./textures/cracked_stone_bricks.xpm
WE ./textures/piston_top.xpm
EA ./textures/purplestone.xpm
S ./textures/barrel.xpm
F 255,0,255
C 51,26,255

1111111111111111111111111111111111
100E000000010202020100000111110111
1000000000010000000100000000000001
1000101000010202020111111100000001
1000101000010000000100000000000001
1000101000011100111111111110111111
12000000002000000001      101
10002000000000000021111111101
10000000000000002000000000001
10000020000000000021111111111
11111111111111111111