R 800 800
NO ./textures/bookshelf.xpm
SO ./textures/cracked_stone_bricks.xpm
EA ./textures/purplestone.xpm
WE ./textures/piston_top.xpm
S ./textures/barrel.xpm
C 51,26,255
F 255,1,255

1111111111111111111111111111111111
1000000020010000000100000000000001
10000S0000010000000100000000000001
1000000100010000000011111110000001
1000101000010000000100000000000001
1000121000011100111111111110111111
10001010000000000001      101
10000000020000000001111111101
10000200000000000000000000001
10000000000000000001111111111
11111111111111111111
